#############################################
#
#
#
#
#
#
#
#        BBBBBBBBBBBBBBBBBBBBBBBBBBBBBBBBBBB#
# > B M  BBBBBBBBBBBBBBBBBBBBBBBBBBBBBBBBBBB#
#BBBBBBBBBBBBBBBBBBBBBBBBBBBBBBBBBBBBBBBBBBB#
#BBBBBBBBBBBBBBBBBBBBBBBBBBBBBBBBBBBBBBBBBBB#
#############################################